111111111111111
120100000000001
100100111100001
100004000100001
100000000101401
111111100101001
100000000101001
100100001100001
104100000000001
100111001111001
100100000000001
111111111100001
100000000000001
133300000000001
111111111111111