14 13 3
0000000000000
0011101101110
0111111101110
0100011111110
0210001000110
0110111110110
0110181110110
0110115110110
0110188110110
0110111110110
0120000000110
0111111111120
0111111111110
0000000000000