################
#######@########
#######$########
#######***$@####
###@$**O*#######
########*#######
########$#######
########@#######
################
################
19 4 7