9,9,4,
35,35,35,35,35,35,35,35,35,
35,32,32,32,79,32,32,32,35,
35,32,32,32,32,32,32,32,35,
35,32,32,32,88,32,32,32,35,
35,79,32,88,64,88,32,79,35,
35,32,32,32,88,32,32,32,35,
35,32,32,32,32,32,32,32,35,
35,32,32,32,79,32,32,32,35,
35,35,35,35,35,35,35,35,35