00111000
00121000
00101111
11140421
12043111
11114100
00012100
00011100
