111110000
100010000
104010111
104310121
111411121
011000021
010001001
010001111
011111000
