9,9,3,
35,35,35,35,35,32,32,32,32,
35,32,32,32,35,32,32,32,32,
35,32,88,32,35,32,35,35,35,
35,32,88,64,35,32,35,79,35,
35,35,35,88,35,35,35,79,35,
32,35,35,32,32,32,32,79,35,
32,35,32,32,32,35,32,32,35,
32,35,32,32,32,35,35,35,35,
32,35,35,35,35,35,32,32,32.