0111111100
0000100000
0111111100
0100000111
1141110001
1003400401
1022104011
1122100010
0111111110
0000000000