01111100
01031110
01040010
11101011
12101001
12400101
12000401
11111111