0000000000
0001111111
0011001031
0010001401
0014004001
0010411001
1110401011
1222220010
1111111110
0000000000