00000000
01111110
11000011
10404401
12222221
10440401
11103111
00111100
