1 1 1 1 1 1 1 1
1 1 1 9 1 1 1 1
1 1 1 0 1 1 1 1
1 1 1 5 0 5 9 1
1 9 0 5 3 1 1 1
1 1 1 1 5 1 1 1
1 1 1 1 9 1 1 1
1 1 1 1 1 1 1 1