1 1 1 1 1 1 1 1 1 1
1 1 0 0 0 0 0 1 1 1
1 1 5 1 1 1 0 0 0 1
1 0 3 0 5 0 0 5 0 1
1 0 9 9 1 0 5 0 1 1
1 1 9 9 1 0 0 0 1 1
1 1 1 1 1 1 1 1 1 1