01111110
01000000
01000000
01111100
00000010
00000010
00000010
01111100
