00000000
01000000
01001000
01001000
01111110
00001000
00001000
00000000
