00111100
01000010
01000010
00100010
00011100
00001000
00001000
00001000
