00000000
00111000
01000100
01000100
00011000
01101100
01000010
00111100
