00000000
00010000
00100000
01111000
01000100
01000100
00111000
00000000
