00010000
00100000
01001000
11111100
00001000
00001000
00000000
00000000
