00111000
01000100
01000100
00001000
00010000
00100000
01111100
00000000
