#########################################################.##########################################
#####################################..###############################################.#############
#####################################..##############################################..######.######
#################.################.....#############################################...##.....######
#################.################.###.##########################################....#.##.###.#.####
#################..#############...###.##########################################.####.##.###.######
#################..#############.#####.###.######################################.##...##.###.######
#################....#####.####..#####.###.....#################################..#..#.##.###.######
#################.##...########.######.###.###....############################...##.##.##.###.######
#################.####...######.######.###.######....#####################.....###..##.#..###.######
#############.###.######.######.######.###.#########.###################...######..###.#.####.######
#############...#.######.######.######.###.########.............#######..########.####...####.######
#############.#.....####.######.##...#.###.########..########...#######.#########.####.######.######
#############.###.#.####.###....##.#.#.###.######......#####..#########.#######...####.######.######
#############.###.#..###.###.#####.#.#.###.#####..####.#####.##########.#######.######.######.######
#############.###.##.........#####.#.#.###.###...#####.#####.#########..######..##.....######.######
#############.###.###........##....#.#.###.##..#######.####..######....#######.##..###.######.######
#############.###.###.##.###....####.#.###.##.########.####.#######.#########..##.####.######.######
#############.###.##..##.###..#.####.#.###.##.#.######.####.######..#######...###.####.######.######
#############.###............##...##.#.###....######...............#######..#.....####.######.######
#############.......###...##.####.##.#..............................................##.######.######
########.#######..#####...#######.##....##.######....###.##.##############.##.#....###.######.######
################...####...#######..#...##..#####..#####.....##########..........######.######.######
################.#..####...#######.....#...###...###....#.#########....###.##..#######.######.######
###############..##...#..#.#######...#..............................#####.....########.######.######
##############..###......#..######.........##......####.##..##.....#######.###########.######.######
#############..####.###..##.######.........#..#....####.###.##..##....##...###########.######.######
###########.........####..#.######.#.........##...#####.###....######..#..############.######.######
########....#.##########..#......#.#....##............#.####..########....#.........##.######.######
########.##...##########...#####.#.#..........#######...#####....#.###...#..######.###.######.######
#######..#..############...........................................................##..######..#####
#######.##.#############...###....##.........#.......#...........###...##..########....######.######
#######.##.#############.#.#####.......#.#..########.##.#...####.......##.#########.##.######.######
######..#..#############.#..####.....#.#....########......######..........#########.##.######.######
######.##.##############.##..........#.#.#.##########....#######..#....############.##.######.######
#####..##.##############.............#...#.#########.....######........#######......##.######.######
#####.###.##############..........#..#..............................................##.######.######
#####.##..#############........##.#.....##.#######.##......#...##......#######.####.##.######.######
#####.##.##############....#.####........#.#######.#....#.#..#.....##...######.###.....######.######
#####.##.###########.........###.......#...#######......#......###.###..######.#######.######.######
####..##.###########.##...#####...............#............#######.###...####..##.......#####.######
####.###.######......##.#.#####..#.....###..#.....#.#.#....#######..##.#...##.###.####..#####.######
####.###.######.#######.#.#####..#.##...##....#..##.#.#.....#.#####.##.###....###.####..#####.######
####.###.####...#######.#.####..##.#....##..........#.#.##........................####..#####.######
####.##.......#########.#.####.#...#.#...#.........##.#.###.#########..............###..#####.######
####.....##############.#.####.#.###.#.#....#....#..#.#..##.##########.........#.#.###..#####.######
###...#.##############.........................####.....###..########..#######...#.###..#####.######
##...##.##############..#........##..#..............#..#####...######..######....#..##..#####.######
#..#.##.#############..........#.......###...#.####.#..###.###..#####..######.#..##.##..#####.######
#.#..##.#######....................###.###..##.####.#..########.####...######.##.##.....#####.######
#...###.#######.####.........#...####.......##.####...###.#####..###...####...##.#####..#.....######
#..####.######...##.....#......###.....####....###.....#########..#....####.####.#####..#.##########
#..####.######.#.....##.#.##...###.###.####.##..#......##########...#..####.####.#####..#.##########
#..####..#####...#..##....##.#.###.###.####.##......#..##########......####.####....##....##########
#..####.######.#.#...#..#.#..#.###.###.####.##.#.......#########..#....####.#######.##...###########
#..####.######.#.....#..#......##..###.####.##....###...................###.#######.##.....#########
#..####.######.#.....#..#.#...##..####.####.##...####...#######..#####.#.##.#######.....##...#######
#..####.######.#.............###.#####.####.#....####.#...#####..#####.####.#######.##..####...#####
#..####.######.....###.....#.###.#####.##...................................#######..#..######.#####
#..####.######.....###.....#.###.#####.###...#..#####.#.#.##..#.###.####.....######.....######.#####
#..####.######.....##........###.#####.###...................##.##########..........#...######.#####
#..####..........#.##...#..............###..##..#####.##...####.####....................######.#####
#..##########....#......#.#.#..#######..##..##.######.##..#####.####.######........##.....####.#####
#..########....#.#...#..#.#...########..##.....######.##....###.#....######......#.###..#...##.#####
#..########.##.#....##..#.#..#########..##..##.######....##..##...#########.##.###......###..#.#####
#..####.....##.....###..#.#...######........##.######..#####.##..#########..##.....##...####...#####
#..####.######...#.###..#...#.######.#.#....##.######..#####...........#.......###.##...######.#####
#..####.#####....#.###..#..##.#####..#.....................####..#####.......#####......######...###
#..####.#####....#.#.#.....##...###.##.##.#.##.######.####.####....####.#..E##########..######.#...#
#..####.###......#.###..##.####..##.##.##...##.##.##..####...##.##.###....#..#######....#####..###.#
#..####.###.#..#.#.###..##..####.##.##.###..##.#####..######.##.##..#...####..######.#..##....####.#
#..####.###.#..#.#......###.####.##.##.###.................................................#######.#
#..####.###....#.#..##..###.####.##.##.####.##.##.###.########...##....#######..#.####..##########.#
#..####.###..#.#.#..##..###...##.##.##.####.##....###.#########..#.....########...#####.##########.#
#..####.###..#.#.#..##..#####..#.##.##.####.##..#####.###..........#.#.##########.#####.##########.#
#..####.###..#.#.#..##..######...##.##.####.##..#####.###.#####......#...#######...####.##########.#
#..####.###..#.#.#.##...#######..##.##.####.....#####.....#####..#..####.########..####....#######.#
#..####.###.##.#...#..#.#######..##.##.####.##.######..########.#..#####.########..####.##.#######.#
#..####.#...##.#.#.#.##.#######.....##.####.##.####...####........######..######...####.##..######.#
#..####...#.##.#.#.#.##.########.##.##.####.##.###..#.####.####..########....###.#.####.###.######.#
#..########......#.#.##.########.##.##.###..##.##..##.####.###...#####.####......#..###.###.######.#
#..#######..##.#.#.#.##.########.##..#.###..##....###.####.##...##########..##.####...#.###.######.#
#..#######..##...#...##.##.#####.##..#.###..##.######.####.##.#.#########..###..#####...###...####.#
#..#######..###.....###.#.######.##.........#########.#....#..#.#########.#####..####...#####.####.#
#...#..###..####.#..###.########.##..#.####.#########...#....##..###......######..##..#.#####...##.#
##..#...##..####.#.####.########.##....####.#######...###.######.###.############..#.##....####.##.#
##......##P.####.#..###.########.##..............................................................#.#
##.##.......##.....................................................................#.######.######.#
##.##.##.#..##.#.##.....................................................###########..######.######.#
##.##.##.......#.######.###########..#.####.###########################..##########.#######.######.#
##.##.####..####.######.###########..#.####.#########################.##.##########.#######...####.#
##.##.####...###.######.###########....####.############################............#########.####.#
##.##.#####....#.######.###########.#....##.####################################...##########.####.#
##.##.######...#.######.##########..##......####################################...##########.####.#
##.##.#######..#.######.########...####.##..#################################....#.##########.####.#
##.##.#######..#.######.########.######..#...################################.####.##########......#
##.##.########....#####.##.......#######.....################################.####..#############..#
##.##.########.#....................................................................##############.#
##.##.########...######..##################...................................####################.#
##....#################.##########################################################################.#
