#######
#.....#
#.###.#
#.#P#.#
#...#.E
##.##.#
#.....#
#######
