00111000
01000100
00000100
00011000
00001000
00000100
01000100
00111000
