00000000
00111100
00100000
01110000
00001000
00010000
11100000
00000000
