00000000
01111110
00000100
00001000
00010000
00100000
01000000
00000000
