00000000
01111100
01000100
00011100
00001100
01000100
01111100
00000000
