7 7
#######
#  OP #
# #O# #
#   C #
#OCC ##
#  ### 
####   
